###############
#A        #   #
# ###  ###    #
#             #
### ##  ### ###
#             #
#   ##  #######
#   #        ##
#         #   #
# ###  ###    #
#             #
### ##  ### ###
#             #
#   ##  #######
#   #        ##
#        #    #
# ###  ###    #
#             #
### ##  ### ###
#             #
#   ##  #######
#   #       B##
###############
